{
         "3": "S",  
        "6": "S",  
        "12": "S",  
        "14": "P",  
        "15": "S",  
        "16": "S",  
        "22": "P",  
        "23": "L",  
        "25": "S",  
        "28": "S",  
        "29": "S", 
        "30": "S",  
        "31": "S", 
        "32": "S"
    }
    
    
     